HAPPY
Happy - Pharrell Williams
Good Life - OneRepublic
Can’t Stop The Feeling! - Justin Timberlake
Best Day Of My Life - American Authors
Walking On Sunshine - Katrina & The Waves
Stronger (What Doesn’t Kill You) - Kelly Clarkson
Good As Hell - Lizzo
On Top Of The World - Imagine Dragons

SAD
Someone Like You - Adele
Stay - Rihanna ft. Mikky Ekko
When I Was Your Man - Bruno Mars
Let Her Go - Passenger
All I Want - Kodaline
Say Something - A Great Big World & Christina Aguilera
Fix You - Coldplay
Jealous - Labrinth

ANGRY
Numb - Linkin Park
In The End - Linkin Park
Stronger - Kanye West
Breaking The Habit - Linkin Park
Till I Collapse - Eminem
Lose Yourself - Eminem
Hail To The King - Avenged Sevenfold
Bodies - Drowning Pool

CHILL
Sunset Lover - Petit Biscuit
Weightless - Marconi Union
lovely - Billie Eilish & Khalid
Location - Khalid
Ocean Eyes - Billie Eilish
Redbone - Childish Gambino
Coffee - beabadoobee
Night Owl - Galimatias

EXCITED
Can’t Hold Us - Macklemore & Ryan Lewis
Turn Down For What - DJ Snake & Lil Jon
Uptown Funk - Mark Ronson ft. Bruno Mars
Don’t Stop Me Now - Queen
Party Rock Anthem - LMFAO
Titanium - David Guetta ft. Sia
I Gotta Feeling - The Black Eyed Peas
Shake It Off - Taylor Swift